3
5
10
S-----XXXX
XX-XX----X
X-----XX-X
X-XXXXXX-X
X--------F
12
15
S-------XXXXXXX
XXXXX-XXXX----X
X---X---X--XX-X
X-XXX-X---XX--X
X-X---XXXX----X
X-X-XX-----XXXX
X------XXX----X
X-XX--X-X----XX
X----XX----XXXX
XX-X--XXXXXF---
XX-XX-X---XXXX-
X---X----------
2
3
SX-
-XF